2222222222222222222222222222222222222222221111122222222222222222222222
2222222222222221111111111112222222222222211111112222221111111111111111
2222222211111111111111111111111222211222221111122221111111111111555555
2222111111111111111111112212211111111134222212224411212111115555556665
2221111155551111311111112111211111111113334414443311111111155566666666
2211111566665113431111111111111111111111113313311111212111555666666666
2211111566651111311111112111211111111111111111111111111115556666666666
2221122255511111111111112212211111111111111111111111111115566666666666
2222222111111111111131111111111111111111111111111111221155566666666666
2211121111111555111343111111111111111111111111111111122122666666666666
2211121111115666511131111111115515511111111131313131311112222266666666
1111111111556666551111111111556212655111111111111111111111122222666666
1211121111156665311131313115222212222511111313141413131111111112222266
1211121115566653431111111115621111126511111111111111111111111111111222
1222222111555511311313131311111111111111111131413141411111111111111122
1122222111111111111111111115621111126511111111111111111111111111111222
1112222221111111111131313115222212222511111314131413131111111111112222
1112555555555111111111111111556212655111111111111111111111111111122211
1125556666655522221133311111115515511111111131313131311111111112221111
2222566666222222222334433113111111111311111111111111111111111111111111
2226666622221112222223331111141212141113111111111111111111122211111122
2266666222111111111122211113111111111311111111111111111111221111112221
2266622221111333111112222111141212141113111111111111112221111111122111
2222222221123344332111111113111111111311111111111122222111111112111111
2211112221224333322211111111141212141113111111111111111111222111111111
2111111221122442212222112223111111111311111111111111111122211111111112
3331111111112221111221111122221111111111111111111111122221111111111122
4433311111122211111111111111111122222111112221221111111111111122222222
4444333222222111112222211111222222111111222222222112222211112222222222